{
    "100": 1,
    "300": 2,
    "600": 3,
    "1000": 4,
    "1500": 5,
    "2100": 6,
    "2800": 7,
    "3600": 8,
    "4500": 9,
    "5500": 10,
    "6600": 11,
    "7800": 12,
    "9100": 13,
    "10500": 14,
    "12000": 15,
    "13600": 16,
    "15300": 17,
    "17100": 18,
    "19000": 19,
    "21000": 20,
    "23100": 21,
    "25300": 22,
    "27600": 23,
    "30000": 24,
    "32500": 25,
    "35100": 26,
    "37800": 27,
    "40600": 28,
    "43500": 29,
    "46500": 30,
    "49600": 31,
    "52800": 32,
    "56100": 33,
    "59500": 34,
    "63000": 35,
    "66600": 36,
    "70300": 37,
    "74100": 38,
    "78000": 39,
    "82000": 40,
    "86100": 41,
    "90300": 42,
    "94600": 43,
    "99000": 44,
    "103500": 45,
    "108100": 46,
    "112800": 47,
    "117600": 48,
    "122500": 49,
    "127500": 50
}